++,,###,,++
++,,#,#,,++
,,,,#,#,,,,
,,,,#,#,,,,
#####,#####
#,,,,,,,,,#
#####,#####
,,,,#,#,,,,
,,,,#,#,,,,
++,,#,#,,++
++,,###,,++